-|s--p||f|
w|-|w-||-|
p-s|--||-|
||||-----|
---|||||||