-|----||f|
w|-|--||-|
p-s|--||-|
||||-----|
---|||||||