-|----||f|
w|-|--||-|
p--|--||-|
||||-----|
---|||||||