-|----||f|
-|-|--||-|
p--|--||-|
||||-----|
---|||||||