First cave
--_________________|
|-__--w--__________|
|----___------s____|
|_______-__________|
|__p--w--__________|
|_______-------____|
|_______-_____p____|
|__------__________|
|__-_______________|
|__f_______________|