Scary Dungeon
-|w--p||w|||_|_____|
-|-|w-||-|||w|_____|
p-s|-s||-|||-|_____|
||||-----|||----p|_|
|__|-|_____|-|_____|
|__|-|_____|---|___|
|__|-----w||-|_____|
|__|-|_____|-|_____|
|__|---------------|
|__|______________f|